BBBBBBBBBBBBBBBBBBBBBBBBBBBBBBBBBBBBBBBBBBBBBBBBBBBBBBBBBBBBBBBBBBBBBBBBBBBBBBBBBBBBBBBBBBBBBBBBBBBBBBB
BDDDDDDPDDDDDDDDDDDDDDDDDDDDDDDDDDDDDDDDPDDDDDDDDDDDDDDDDDDDDDDDDDDDDDDDDDDDDDDDDPDDDDDDDDDDDDDDDDDDDDB
BDDDXDDPDDDDDDDDDDDDDDDDDDDDDDDDDDDDDDDDDDDDDDDDDDDDDDDDDDDDDDDDDDDDDDDDDDDDDDDDDDDDDDDDDDDDDDDDDDDDDDB
BDDDDDDPDDDDDDDDDDDDDDDDDDDDDDDDDDDDDDDDDDDDDDDDDDDDDDDDDDDDDDDDDDDDDDDDDDDDDDDDDDDDDDDDDDDDDDDDDDDDDDB
BDDDDDDDDDDDDDDDDDDDDDDDDDDDDSSSSSSSSSSSSSSSSDDDDDDDDDDDDDDDDDDDDDDDDDDDDDDDDDDDDDDDDDDDDDDDDDDDDDDDDDB
BDDDDDDDDDDDDDDDDDDDDDDDDDDSSSSDDDDDDDDSSSSSSDDSSSSSDDDDDDDDDDDDDDDDDDDDDDDDDDDDDDDDDDDDDDDDDDDDDDDDDDB
BDDDDDDDDDDDDDDDDDDDDDDDDDDDDPDDDDDDDDDDDPDDDDDDPDDDDDDDDDDDDDDDDDDDDDDDDDDDDDDDDDDDDDDDDDDDDDDDDDDDDDB
BDDDDDDDDDDDDDDDDDDDDDDDDDDDDDDDDDDDLLLLLLLLLLLLLDDDDDDDDDDDDDDDDDDDDDDDDDDDDDDDDDDDDDDDDDSDDDDDSDDDDDB
BBBBBBBBBBBBBBBBBBBBBBBBBBBBBBBDDBBBBBBBBBBBBBBBBBBBBBBBBBBBBBBBBBBBBBBBBBBBBBBBBBBBBBBBBBBDDDDDBBBBBBB
BDDDDDDDDDDDDDDDDDDDDDDDDDDDDDDDDDDDDDDDPDDDDDDDDDDDDDDDDDDDDDDDDDDDDDDDDDDDDDDDDPDDDDDDDDDDDDDDDDDDDDB
BDDDDDDDDDDDDDDDDDDDDDDDDDDDDDDDDDDDDDDDDDDDDDDDDDDDDDDDDDDDDDDDDDDDDDDDDDDDDDDDDDDDDDDDDDDDDDDDDDDDDDB
BDDDDDDDDDDDDDDDDDDDDDDDDDDDDDDDDDDDDDDDDDDDDDDDDDDDDDDDDDDDDDDDDDDDDDDDDDDDDDDDDDDDDDDDDDDDDDDDDDDDDDB
BDDDDDDDDDDDDDDDDDDDDDDDDDDDDSSSSSSSSSSSSSSSSDDDDDDDDDDDDDDDDDDDDDDDDDDDDDDDDDDDDDDDDDDDDDDDDDDDDDDDDDB
BDDSSSSDDDDDDDDDDDDDDDDDDDDSSSSDDDDDDDDSSSSSSDDSSSSSDDDDDDDDDDDDDDDDDDDDDDDDDDDDDDDDDDDDDDDDDDDDDDDDDDB
BEDDDDDDDDDDDDDDDDDDDDDDDDDDDPDDDDDDDDDDDPDDDDDDPDDDDDDDDDDDDDDDDDDDDDDDDDDDDDDDDDDDDDDDDDDDDDDDDDDDDDB
BDDDDDDDDDDDDDDDDDDDDDDDDDDDDDDDDDDDDDDDDDDDDDDDDDDDDDDDDDDDDDDDDDDDDDDDDDDDDDDDDDDDDDDDDDSDDDDDSDDDDDB
BBBBBBBBBBBBBBBBBBBBBBBBBBBBBBBBBBBBBBBBBBBBBBBBBBBBBBBBBBBBBBBBBBBBBBBBBBBBBBBBBBBBBBBBBBBBBBBBBBBBBBB